S 10 10
W ../sprites/colorstone.png

1111111111
1000000001
1000000001
1001110001
1001010001
1000000001
1000000001
1000010001
1000000001
1111111111
